 3, 1, 1, 1, 1, 1, 7, 1, 1, 1, 4
 2,12,13,12,12,14, 2,12,12,12, 2
10, 1, 4,13, 3, 1, 8,12,12,12, 2
 2,12, 6, 1, 5,13,10, 1, 1, 1, 8
 2,12,12,12,12,12, 2,12,12,13, 2
 6, 1, 1, 1, 1, 1, 9, 1, 1, 1, 5