***************
*BBBBB* A *   *
***C*** A * * *
*A*** ***** ***
*AAAAA*  C* * *
* A*AA* B * ***
*AA*AA* B *
***********